screen_name	description
fiahrichard3	I am a loyal and cool headed guy
cthomps6	
jj67961334	
laurannevans	big dumb bitch. she/her
lankunb	
johnnyboycomic	If youâ€™re reading this, you have no life. Facebook/Instagram: @JohnnyBoyComic #johnnylambrose #johnnyboycomic #comedian #comedy #standupcomedy
alayinde2018	cool calm
MadKingBell	
PrescottIraida	soy de bocas del toro naci el 12 de diciembre del 2000 me encanta la musica
Aikhid1	ğŸ˜
allhailharuhi	It's me, ya' girl! Bisexual succubus. Queer af. AniBlogger. Known to delete accounts. Wife of Mereoleona. Diabetic T-1. Currently stans: Akudama, Tampa Bay ğŸ’€âš”ï¸
Iva12282257	
cryoshower	Cold therapy at the push of a button - data led and technology driven. #Train_with_intensity #Recover_with_Science
yuep48063902	åŒåŸyue pp
Abdulai45329940	too much peace in my mind... ğŸ˜
BrandenGrant	â­ï¸â­ï¸ğŸ‘‘
MichaelRGuzik	Former Congressional candidate for #CA29 #resist It's We The People, not we the few #weareallhuman Personal @evo7ve
TMozaffarimehr	
Godistruth7	Once upon a time I was born, I did many things, dreamed many dreams, laughed until I cried, and cried until I laughed. Now I know that Love is all that matters.
WillieW66000485	
WadOfHate	Covert Ops. Deep 3s. High caliber holder. 3 digit powerslides.
Goldflight007	â€¢ @SmokinBarrelsCo ğŸ’¨â€¢ Mamaâ€™s Closet Podcast @MsB_ClosetğŸ™ â€¢ @thefastbreak3 ğŸ€ https://t.co/g6C7i6WMZJ
Mariano09956181	
brookedial1	c/o 23 ğŸ˜Œ PESğŸ¾ğŸ’™ student athlete
FranchescaMCan1	granny Leo married Christian mother no drugs, drinking and driving. Got pregnant 1985 been married thirty-five years still today.ğŸ˜‡ğŸ˜ğŸ’šğŸ’¯
hancock1403	Special Olympian, #1 Basketball Manager in the Country, Midland University Basketball Manager, Video Gamer, Autism
mcintyre1792	
rick20428015	Licensed manufacturer of silk for the Asian Games
ntisamuelpetoa	Fashion Designer
joe58151157	
JuniorR28759238	No te preocupes por lo que la gente piensa no lo hacen muy a menudoğŸ˜
curlypaige	Oahu, HIğŸŒ´| ğŸ³ï¸â€ğŸŒˆ|
NicoTeeN___TV	Yare Yare Daze
Mohamed59270040	HonnÃªte
mexican_proud1	Just livin' life!
tanawhatt	
redzallday	
SOCEGZ	
BlauchSue	
LISANDRO48	Raised in the school of hard knocks Nwk, NJ. With ALLAHS blessings I have climbed to higher height helping any man in need.
ShanticeBuckne1	My journey as his wife ğŸ’ğŸ’ğŸ’#unapologetic #MyBestLife #BucknerTakeover #PatsNATION
mamavicky73	
Nicole60040766	
M_Grand81	
_slipshape	slipshape is characterised by fluidity, uncertainty, shape-shift & flow
Cloinner1	
MrMike21	over all, badass at life. Yes you are right...That is a tortilla mask on my face. There was randomized shit on this Twitter when I highjacked it back LoL
nalanz10	
UnmaskingPolit1	
brxdon16	. hmu
Keion40245157	
VillagevoicesR	Village Voices Show Las Vegas politics, news, community talk. Hosted by Miriam Gibson and Shannon Churchwell.
shemsmusa1	
JordanHeiress3	True sports fan! Favorite love is basketball! Doing what I do and doing it well!
ShawnJo51989019	love sports betting..vegas baby
julia_irawo	#BasketballPower ğŸ€ğŸ§¡ğŸ

                                     TikTok: @ girlbask.reactions
zachshonda2	YouTube channel zachshonda gaming Instagram zachs_honda Tik Tok zachshonda Xbox zachshonda I play CODMW, FORTNITE and FORZA HORZAN 4 everyday 17
bbwalker1966	
JNicole28813594	
here4thebuckets	Iâ€™m here for the buckets. #SpursNation #SpursFam #GoSpursGo #Rebuild
LericStop	LericStop- Women & Men's Fashion
Great stylish Products that make you feel good 
A new type of store front 
No Hidden Fee's 
https://t.co/75ly6jjVUr
hey_its_toonboy	From the Land of the Rising Sun to The City by the Bay...Greetings!!  All things nerdy to the cool that's me.
KarlaBu34043662	K.M.B.L
Verle71005603	looking for a older female that tried of the games,and would love to go out for coffee,ice cream,or a concert in the park.
chelless	â€œ we must all face the choice between what is right and what is easy â€œ Albus Dumbledore
DelaineFloerch1	DM For Prices
onmeyallsumhoes	im not your boyfriend
felixtang1211	A man, 36, hong kong, love sexy girls, yeah!
leveluplasvegas	The next-level entertainment concept by @hakkasangroup     
ğŸ“@MGMGrand ğŸ“ŒBook Now: https://t.co/oNazEYvg9m
dazegrl	idek
frostmanlv	Dream Big - its fun
Jane24306988	Soccer Basketball
Carter75342328	
IshaaaIam	Reckless Ass Mouth ğŸ’‹ Attitude Bad ğŸ¥µ
johnarias11	
lilChef30	Avery Ragland - Mustang Class of 2026
mentalecho1	Oakland Raider fan New York Yankee fan
Miguel_ACR99	
girls_bpbball	
TrinityKimble	Fan First mentality while aspiring Artist. 7zero2tv@Youtube.com Las Vegas.   Follow me
scce438	Job in education
gramaloops702	mgibarria
alberto45843262	
income_us	focus
rhianna52	#Ball is life ğŸ€
PhyllisHunterG1	
mPSZQ7ljkeFnVRM	EXPERTS IN blockchainï¼ŒLooking for trends, looking for 10000 times digital currency
cooleyk20	
asiadee16	
KPtoolive	01/27/19ğŸ§¡ || UNT-Dallas commitğŸ’šğŸ’™âœ¨ #BLMâœŠğŸ½âœŠğŸ¾âœŠğŸ¿
BowmanVerlan	I BELIVE IN THE LORD "JESUS" CHRIST!! I AM A VERY SWEET WOMAN!! I BELIEVE IN BEING FATHFUL AND HONEST & ALWAYS TRUE IN A RELATIOSHIP ALWAYS. NO HALFSTEPPING!!ğŸ˜˜
PhairOKAY	Immortal

#WeTooOriginal
LShackelly	
jaelyn60937692	Life Christian Academy c/o 21â€™ğŸ¦…
pulltabpodcast	#onwisconsin  #gopackgo  #thisismycrew  #fearthedeer #vegasodds #sportsbetting    Sports banter with a WI emphasis / Wagering Insight and Analysis of Vegas odds
David10277545	
kinghill5000	
mt_basket	
Lucky94648572	Dad, Racecar driver, Flannel wearing metal artist
darealistlala	
California9o9	FULLY OPEN UP THE USA !ğŸ‡ºğŸ‡¸
