screen_name	description
paulfingmurphy	Life moves pretty fast out there. If you blink, you could miss it.
JulieMendoza206	Product Recruiter @ Twitter | UW Alum ğŸ’œ| Î£Î›Î“ | #MyViews #BlackLivesMatter
BrenoGa01964440	
nickbehnen19	WSU Alum
Oswaldo10808143	
AbelaBelay	Environmental Engineer, inter-issues analyst and going to be writter...
rreesejr_1	#aamu20 ğŸ¶ ğŸ“ğŸ“š. Class of 2020. Host of the Tennessee Valley Sports Podcast/Blog. Former Voice of AAMU Basketball
ethanbmatt	nice jewish boy /// music on website
Omar5paredes	
kmzyv	
josephyouness22	Sports
Real Madrid bayern Munich, James Rodriguez, Cristiano
iam_sammi	Writer and copy editor for @YOLKdotTV and book recommender for @nwasianweekly. Harry Potter expert (go ahead, test me). Gymnast-turned-yogi.
GNgamuriaki	impossible is nothing
palomanunez	she/her | Actor | Comedian | Writer | SHAZAM | Second City Alumna | Baroness Von Sketch | She The People | Booger flicker |
Krisconway10gm1	@
RoQstaR0702	Trinityâ€™s #1 Fan!
Dabs4077	Love ğŸ€ keepğŸ”¥ğŸ€â›¹ğŸ¾â€â™‚ï¸
kattybiscone	A one woman sass factory.
falatujango	á»Œmá» Ã’gÃºn | original negro drama | poeta Ã  margem da tua visÃ£o
yhenew_andargie	áŠáƒáŠá‰µ á‰ áŠáƒ áŠ á‹­áŒˆáŠáˆâ€¼   













































#áŠ¢á‰µá‹®áŒµá‹« 
#Minilik #Tayitu 
#áŠ á‹µá‹‹ #Lalibela
#á‰¡áŠ“ #áŒá‹•á‹ #áŠ áˆ›áˆ«
 #GERD | #Aksum  #Tana #áŠ áˆ›áˆ¨áŠ› 



 ğŸ’šğŸ’›â¤ï¸
cambridge80s	
aleksandargrkov	
CuinMiranda1	Living life one ğŸŒ® at a time | Boston â¡ï¸DC â¡ï¸SeattleğŸ“ | #foodjustice and #techforgood nerd | Tweets my own
GeoSpica	
ineedapancake	
annmyramusic1	Born in Nashville, raised in the East Coast now living my dreams in Santa Monica, California. Debut album released in 2012.
ericamars__	Aking sinta ikaw na ang tahanan at mundo ğŸ¤â™ ï¸
lele_bekah	
sumthinsumthn	It go somethin', somethin', somethin', can't remember nothin'
mandaamh	Hiiii
GSea33	NBA and NFL fan
AidanConCam	immigration & refugee lawyer | (they/them)
OtternessShauna	ğŸ€ğŸ Mom of: Tiana, Lanaya, Dâ€™naesha, Malea, & Geremy.. Students first, athletes second. Kasson-Mantorville b-ball, volleyball, wrestling..
GentsCoachD	Menâ€™s Basketball Coach at Centenary College - LA. ğŸ€ Content Provider | Serving others through ğŸ€| #Thankful
madfigz	your friendly neighborhood goofball
tallurishilpa	
austen_valny	don't fuck with me. #AV#
megstocker	Brand Manager. ğŸ¥›â˜•ï¸ğŸŒ± Musician. ğŸ¶ğŸ¸ Photographer. ğŸ“·ğŸ”ğŸŒ•ğŸ± Funko collector. â¤ï¸ğŸ‘¾ğŸ§™â€â™‚ï¸ğŸ¦¸â€â™€ï¸ Family adventures. ğŸ‘©â€ğŸ‘©â€ğŸ‘§â€ğŸ‘¦ Mountain Meg. ğŸğŸŒ„ğŸŒŒ
karisinclairr	give to those who canâ€™t give at all. | rhs varsity basketball.
_blutori	for the love of music
DyllanLowe	
msbs713	
evertontinte	Pai. Rotariano. Chairman do IntercÃ¢mbio de Jovens do Distrito 4480. Advogado. SÃ³cio ProprietÃ¡rio do escritÃ³rio Porto & Tinte - Advocacia. Palmeirense. 12's.
SE_Norred	Biophysicist who does computer vision stuff now | ğŸ‘©ğŸ»â€ğŸ”¬ğŸ§¬ğŸ”¬â¡ï¸ğŸ‘©ğŸ»â€ğŸ’»ğŸ¤–ğŸ“½ | Tennesseeâ¡ï¸Seattle ğŸŒ§ï¸ | she/her | opinions my own
seidysaccount	á´®áµ‰â±â¿áµ á¶œáµ’áµáµ–áµ’Ë¢áµ‰áµˆ áµ’á¶  áµ–áµ˜Ê³áµ‰ Ë¡â±áµÊ°áµ— â™‰ï¸
LariBoBerry	Catching up
PolitrixR4Kids	#blacklivesmatter , Pro Guillotines, ACAB
woohthatsright	Just chasing dreams ğŸŒŸ
proftimoteo	prof UNIFMU EducaÃ§Ã£o FÃ­sica; Prof Pos Graduacao Einstein, Pesquisador Celafiscs.
luminog_jysss	ğ“›ğ“²ğ“¿ğ“® ğ“²ğ“· ğ“½ğ“±ğ“® ğ“¼ğ“¾ğ“·ğ“¼ğ“±ğ“²ğ“·ğ“® ğ”€ğ“±ğ“®ğ“»ğ“® ğ”‚ğ“¸ğ“¾ ğ“«ğ“®ğ“µğ“¸ğ“·ğ“°
runningfamily6	Jer 29:11! Love to road and mountain bike, hike and run. l love just about anything that involves the trails. God's creation is amazing!
SierraG87979965	
TashaThorntonR1	
clairetnet21	Assistant Professor of French and Francophone Studies @ Hamilton College
_nataliaamador	Entrepreneur | Creative Writer
JaredMRyan	
STONESTEEL08	WELCOME MOTHERFUCKERâ€¼ï¸
SenSeiFAR	Rick and Morty, Team Nigma DotA2, Steph Curry, Hitman, ex CSS player.
cdowdreilly	Co-Executive Director for CityHealth. Proud mother, wife, and policy nerd.
j_douville25	Director of Sports Partnerships at @CambriaSurfaces
AidanSchwartz13	
murftaz	
RextonCook	Feels like I have a story to share, but it's probably just the desire to retweet Housewives content â€¢ He/him â€¢ Seattle Area, WA â€¢ SLP by trade
DrDemosthene	Positive Vibes Only-.â™¡

â€¢Owner of @healthcareht

â€¢Pharmacist | MD Student | Entrepreneur |Fashion Model
ElleyLisa	
aakshayb	
s_mmathews	
docisions	
patitomia23	â€œAnd have brought humanity to the edge of oblivion: because they think they are white.â€ â€” James Baldwin
ChrisKennedy344	
bluescuba500	opinions are my own
whitneycraw08	I am a human, partner, mom, liberal pacifist, sports enthusiast who believes is equality and basic human rights.
carloskabuthia	
the_noah_barker	78th Governor of Palmetto Boyâ€™s State | Son of Lugoff, SC | UofSC '23 | Advocate for boiled peanuts, Democrats, and the New South |
aan_arab	Student
obama_llama_fur	Making the big shot wouldn't feel so good if missing it didn't feel so awful
-Paul Pierce | Co-host of Bleu Room Insights | Writer for BRI  @BleuRoomInsight
JuliemarOrtiz	Be kind. Be fair. Be free. #vote
tho570	#ç›¸äº’ãƒ•ã‚©ãƒ­ãƒ¼ å¸Œæœ›è€…ã°ã‹ã‚Šé›†ã¾ã‚‹ã‚¢ã‚«ã‚¦ãƒ³ãƒˆãªã®ã§ãƒªãƒ•ã‚©ãƒ­ãƒ¼ã¾ãšï¼‘ï¼ï¼ï¼…ï¼ã€ã“ã®ã‚¢ã‚«ã‚¦ãƒ³ãƒˆã‚’ãƒ•ã‚©ãƒ­ãƒ¼ã—ãŸå¾Œã“ã®ã‚¢ã‚«ã‚¦ãƒ³ãƒˆã®ãƒ•ã‚©ãƒ­ãƒ¯ãƒ¼ã‚’ãƒ•ã‚©ãƒ­ãƒ¼ã™ã‚‹ã ã‘ï¼ã€‘ãƒªãƒ„ã‚¤ãƒ¼ãƒˆã§ã•ã‚‰ã«å¢—ã€…â˜† #followme #ãƒªãƒ•ã‚©ãƒ­ãƒ¼ #ï¼‘ï¼ï¼ï¼… #ãƒ•ã‚©ãƒ­ãƒ¼ãƒãƒƒã‚¯ #æ”¯æ´ #å¿œæ´ #ç›¸äº’ãƒ•ã‚©ãƒ­ãƒ¼
dhanoapaul	
kantybello5	dee system analyst
hp6363	
PhucGiaThanh	
tc_mcdonald	Child of the Most High
Mom of a King ğŸ¤´ğŸ½ğŸ’–
Licensed Life Agent ğŸ’¼
Financial Literacy Coach ğŸ‘©ğŸ½â€ğŸ«
Entrepreneur ğŸ’°ğŸ’µ
USouthAL Grad ğŸ‘©ğŸ¾ğŸ“š
Mermaidnchains	40's, Single,  Autism Mom, reader, cat adorer, confirmed dirty liberal, curse-word-user, feminist, Sai King fan, and speaker of personal truths. DM's are rare.
srinisim	Salesforce | STEM | Software | Service
#1000DaysOfSalesforce
My Tweets Are My Own.
Rakel07180059	Minding my own business and happiness
AnisRezek	
BlakeChilders8	yeth
_WhizKid_	Cooler than the other side of your pillowÂ¦Heart bigger than your AssÂ¦A slice of greatnessÂ¦Praying & GrindingÂ¦Coffee & WhiskeyÂ¦June's Finest|Self-madeÂ¦Arsenal
jjohny1989	
ppaguay	Cinefilo
RobertCVG9	La Vida Es Ser Feliz
deborahjoshuaa	
ddinhviet	#ç›¸äº’ãƒ•ã‚©ãƒ­ãƒ¼ å¸Œæœ›è€…ã°ã‹ã‚Šé›†ã¾ã‚‹ã‚¢ã‚«ã‚¦ãƒ³ãƒˆãªã®ã§ãƒªãƒ•ã‚©ãƒ­ãƒ¼ã¾ãšï¼‘ï¼ï¼ï¼…ï¼ã€ã“ã®ã‚¢ã‚«ã‚¦ãƒ³ãƒˆã‚’ãƒ•ã‚©ãƒ­ãƒ¼ã—ãŸå¾Œã“ã®ã‚¢ã‚«ã‚¦ãƒ³ãƒˆã®ãƒ•ã‚©ãƒ­ãƒ¯ãƒ¼ã‚’ãƒ•ã‚©ãƒ­ãƒ¼ã™ã‚‹ã ã‘ï¼ã€‘ãƒªãƒ„ã‚¤ãƒ¼ãƒˆã§ã•ã‚‰ã«å¢—ã€…â˜† #followme #ãƒªãƒ•ã‚©ãƒ­ãƒ¼ #ï¼‘ï¼ï¼ï¼… #ãƒ•ã‚©ãƒ­ãƒ¼ãƒãƒƒã‚¯ #æ”¯æ´ #å¿œæ´ #ç›¸äº’ãƒ•ã‚©ãƒ­ãƒ¼
Brianna88279787	Do right
mikebigman	Cool man, and happy always
JliaMuoz3	ğŸ€
JSakyi	
hulu_hageresh	
DekuOneforall6	
LluviaHaro	8-30 ğŸ’•
